1111111111111111111111111111
1C000000000000000000000000C1
1000000000000000000000000001
11111111100000P0000011111111
1000000000000000000000000001
1C000000000000E00000000000C1
1111111111111111111111111111